++++++++++++++++++++++++++++
++++++++++++++++++++++++++++
++++++++++++++++++++++++++++
++++++++++++++++++++++++++++
+            ++            +
+ ++++ +++++ ++ +++++ ++++ +
+ ++++ +++++ ++ +++++ ++++ +
+ ++++ +++++ ++ +++++ ++++ +
+                          +
+ ++++ ++ ++++++++ ++ ++++ +
+ ++++ ++ ++++++++ ++ ++++ +
+      ++    ++    ++      +
++++++ +++++ ++ +++++ ++++++
++++++ +++++ ++ +++++ ++++++
++++++ ++          ++ ++++++
++++++ ++ +++  +++ ++ ++++++
++++++ ++ ++++++++ ++ ++++++
          ++    ++          
++++++ ++ ++++++++ ++ ++++++
++++++ ++ ++++++++ ++ ++++++
++++++ ++          ++ ++++++
++++++ ++ ++++++++ ++ ++++++
++++++ ++ ++++++++ ++ ++++++
+            ++            +
+ ++++ +++++ ++ +++++ ++++ +
+ ++++ +++++ ++ +++++ ++++ +
+   ++                ++   +
+++ ++ ++ ++++++++ ++ ++ +++
+++ ++ ++ ++++++++ ++ ++ +++
+      ++    ++    ++      +
+ ++++++++++ ++ ++++++++++ +
+ ++++++++++ ++ ++++++++++ +
+                          +
++++++++++++++++++++++++++++
++++++++++++++++++++++++++++
++++++++++++++++++++++++++++