++++++++++++++++++++++++++++
++++++++++++++++++++++++++++
++++++++++++++++++++++++++++
++++++++++++++++++++++++++++
+************++************+
+*++++*+++++*++*+++++*++++*+
+O++++*+++++*++*+++++*++++O+
+*++++*+++++*++*+++++*++++*+
+**************************+
+*++++*++*++++++++*++*++++*+
+*++++*++*++++++++*++*++++*+
+******++****++****++******+
++++++*+++++*++*+++++*++++++
++++++*+++++*++*+++++*++++++
++++++*++**********++*++++++
++++++*++*+++**+++*++*++++++
++++++*++*+++  +++*++*++++++
+*********++    ++*********+
++++++*++*++++++++*++*++++++
++++++*++*++++++++*++*++++++
++++++*++**********++*++++++
++++++*++*++++++++*++*++++++
++++++*++*++++++++*++*++++++
+************++************+
+*++++*+++++*++*+++++*++++*+
+*++++*+++++*++*+++++*++++*+
+O**++****************++**O+
+++*++*++*++++++++*++*++*+++
+++*++*++*++++++++*++*++*+++
+******++****++****++******+
+*++++++++++*++*++++++++++*+
+*++++++++++*++*++++++++++*+
+**************************+
++++++++++++++++++++++++++++
++++++++++++++++++++++++++++
++++++++++++++++++++++++++++